g,g,g,g,g,g,g,g,g,g,g,g,g,g
g,g,g,w,g,g,g,g,g,g,w,g,g,g
g,g,g,w,b,b,b,b,b,b,w,g,g,g
g,w,w,w,b,w,w,w,w,b,w,w,w,g
g,b,b,b,b,w,g,g,w,b,b,b,b,g
g,b,b,b,b,w,g,g,w,b,b,b,b,g
g,w,w,w,b,w,w,w,w,b,w,w,w,g
g,g,g,w,b,b,b,b,b,b,w,g,g,g
g,g,g,w,g,g,g,g,g,g,w,g,g,g
g,g,g,g,g,g,g,g,g,g,g,g,g,g
